6 6
4 3 8 7
2 0 2 4 2 0 
6 1 2 2 5 1 
3 1 1 0 5 1 
2 2 0 2 0 0 
. / . . . - 
| . . . . . 
. - / . . | 
| . . . | . 
. | . / / / 
/ . / . . . 