5 5
5 2 5 9
0 0 2 0 2 
6 2 2 3 2 
3 3 2 0 2 
3 3 2 0 2 
- . . . . 
. \ . - | 
. . . . . 
. . . . . 
. . . . . 