5 5
6 4 4 8
3 1 1 3 2 
3 1 1 3 2 
4 0 3 0 4 
1 1 3 2 4 
. . . . . 
. . . . | 
. . . . . 
. . . | . 
. | . . . 