5 6
7 7 8 3
5 2 4 1 3 
2 2 4 0 1 
2 1 2 4 4 1 
2 1 2 4 1 9 
. . . \ . 
\ . . . . 
. . . . . 
. . | . \ 
. . . . . 
. . . - . 